##################
#S...............#
###.##.##.#.#.####        
###.....#..#...#E#    
##################