##########
#S.....###
###.##.###        
###.....E#        
##########