##################
#S...#...........#
###.##.##.#.#.#.##        
###...#........###
###......#.....#.# 
###...#..#..#....#  
###....#...#..#.##      
#....#...........#
###.##.##.#.#.#.##        
###...#........###
###......#.....#.# 
###...#..#..#....#  
###....#...#..#.E#      
##################